1111111111111111111111111111111111111
1E000V000P0000000000C0000000000001001
1111111111111111111111111111111111111