1111111111111111111111111111111111111
1V0101010C010101010101010101010101101
1100000000V00000000000000000000V00001
1000000000000000000000000000000000001
1100111100000111001110011100111000001
100000000000010100C0100C0100101000001
1100111100000001000010000100001000001
100C000000000001001110011100001000001
11011110000000010000100C0100001000001
1000000000C00011101110011100001000001
1100C000000000000000000P000C000000001
110011001100110011001100110011000E011
1111111111111111111111111111111111111