1111111111111111111111111111111111111
1C00000000000P00000000000E00000001001
1111111111111111111111111111111111111