1111111111111111111111111111111111111
1V01010100010101010101010101010101101
1100000000V00000000000000000000V00001
1000000000000000000000000000000000001
1100111100000111001110011100111000001
10000000000001010000100C0100101000001
1100111100000001000010000100001000001
1000000000000001001110011100001000001
11011110000000010000100C0100001000001
1000110000000011101110011100001000001
11000100000000000000000P000C000011001
110011001100110011001100110011001E011
1111111111111111111111111111111111111