1111111111111111111
100000000000000E001
1000V00000000000V01
1000111100000000001
1000P00000000C00001
10001100000C0000001
1111111111111111111