1111111111111
1011C1V000001
11100000000C1
100PC10010001
10001001001E1
1111111111111