1111111111111
1010C0V000001
11101000000C1
100PC10010001
10001001001E1
1111111111111