1111111111111
1011C1000E001
11100000000C1
100PC10010001
1000100100101
1111111111111