1111111111111111111
1VVVVVVVVVVVVVVVVV1
1VVVVVVVVVVVVVVVVV1
1CCCCCP0E0000000001
1111111111111111111