111111
111111
111111
111111
1PCEV1
111111