1111111111
1CCCCCCPC1
1CECCCCCC1
1CCCCCCCC1
1CCCCCCCC1
1CCCCCCCC1
1CVCCCCCC1
1111111111