1111111111
10E00101V1
1100010011
10100000C1
11000P1001
1111111111