1111111111
1C0000C001
1000100001
1011C00C01
1100000001
1000000001
1000000001
100P0000E1
10C0000001
1100000001
1011000001
1111111111