1111111111
1000000001
1000100001
1011000001
1100000001
1000000001
1000000001
100P0C00E1
1000000001
1100000001
10110V0001
1111111111